Hhd, Hhd, Hhd, Hhd, Mdd, Mdd, Hhd^Fdw, Hhd, Hhd^Ft, Hhd^Ft, Hhd^Fdw, Hhd, Hhd^Ft, Mdd, Mdd, Mdd, Mdd, Hhd, Hhd^Ft, Hhd, Gll, Hhd, Mdd, Hhd, Hhd, Hhd
Hhd, Mdd, Hhd, Hhd, Hhd, Mdd, Hhd^Fdw, Hhd^Fdw, Hhd^Ft, Hhd^Ft, Hhd^Ft, Mdd, Mdd, Mdd, Mdd, Mdd, Mdd, Mdd, Hhd^Ft, Hhd^Ft, Gll, Hhd^Ft, Hhd^Ft, Hhd^Ft, Mdd, Mdd
Hhd^Fdw, Hhd^Fdw, Hhd^Fdw, Hhd, Hhd, Hhd, Hhd, Hhd, Hhd, Hhd^Ft, Hhd^Ft, Mdd, Mdd, Mdd, Mv, Mdd, Mdd, Mdd, Mdd, Hhd^Ft, Hhd^Ft, Gll, Gll, Hhd^Fdw, Hhd^Fdw, Mdd
Hhd, Hhd^Fdw, Hhd^Fdw, Hhd, Hhd, Hhd, Mdd, Hhd, Hhd^Fdw, Hhd^Ft, Mdd, Mdd, Mdd, Mm, Mm, Mm, Mdd, Mdd, Mdd, Hhd^Ft, Hhd^Fdw, Mdd, Mdd, Gll, Hhd^Fdw, Hhd^Fdw
Mdd, Mdd, Hhd^Fdw, Hhd^Fdw, Hhd^Fdw, Hhd, Mdd, Mdd, Hhd, Hhd^Ft, Hhd^Ft, Mdd, Mdd, Mdd, Uue, Mdd, Mdd, Mdd, Hhd^Ft, Hhd^Fdw, Hhd^Fdw, Mdd, Mdd, Gll, Gll, Hhd
Mdd, Mdd^Fdw, Mdd^Fdw, Hhd^Fdw, Hhd^Fdw, Hhd, Hhd^Fdw, Hhd, Uhe^Dr, Hhd, Hhd, Mdd, Mdd, Mdd, Uue, Mdd, Hhd, Mdd, Hhd^Fdw, Hhd, Uhe^Dr, Hhd, Hhd, Mdd, Gll, Hhd
Gd^Fdw, Mdd, Hhd, Hhd, Hhd, Hhd, Hhd^Fdw, Gd^Fdw, Mdd, Hhd^Fdw, Hhd, Hhd, Uhe^Dr, Uue^Edb, Gll, Uue, Uhe^Dr, Hhd, Hhd, Hhd, Re, Re, Hhd^Fdw, Gll, Hhd^Fdw, Hhd
Gd^Fdw, Hhd^Fdw, Gd^Fdw, Hhd, Hhd, Gd^Fdw, Gd^Fdw, Gd^Fdw, Gll^Edb, Gll^Edb, Gll, Hhd, Gll, Gll^Edb, Gd, Gll, Gll, Gll^Edb, Gll, Hhd, Gll, Gll, Gll, Gll, Gd^Fdw, Gd^Fdw
Hhd, Gd^Fdw, Hhd^Fdw, Gs^Fdw, Hhd, Gll, Hhd, Hhd, Mdd, Gd, Gd, Gll, Gd, Gd, Gd, Gd, Gd^Edp, Gd, Hhd^Fts, Gll^Edb, Mdd, Mdd, Hhd, Gd^Fdw, Gd^Fdw, Gd^Fdw
Mdd, Hhd^Fdw, Hhd, Hhd^Edb, Hhd, Gll, Hhd^Fdw, Mdd^Fdw, Mdd, Mdd, Hhd^Fdw, Gd^Edp, Hhd, Gd^Edp, Gd, Gll, Hhd, Hhd^Fts, Gd^Fts, Mdd, Mdd, Hhd, Uhe^Dr, Hhd^Fdw, Hhd^Fts, Gd^Fdw
Mdd, Mdd, Hhd, Uhe^Dr, Hhd^Edb, Gll^Edp, Gd^Fdw, Gll^Edb, Mdd, Gd^Fdw, Hhd^Fdw, Hhd^Fdw, Hhd, Gd, Gd^Edb, Gll^Edb, Hhd, Hhd, Gd, Gd, Re^Edb, Re^Edb, Hhd, Hhd^Fts, Hhd^Fts, Gd^Fts
Mdd, Mdd, Mdd, Hhd, Hhd^Fts, Gll, Hhd^Fts, Gll^Edb, Gll, Mdd, Hhd, Hhd, Gd^Fts, Gll, Gd, Gd^Edb, Gd, Gd, Gll, Gll, Gll, Re^Edb, Hhd, Re^Edb, Gll^Fts, Gd^Fts
Gll^Ft, Mdd, Gd^Ft, Mdd, Gll^Edb, Re, Hhd, Hhd^Fts, Re^Edb, Gll, Gll, Gd^Fts, Hhd, Gll, Gll, Gd, Gd, Gll, Re^Edb, Hhd, Hhd^Fts, Gll, Gll, Gll, Gll, Gll
Gd^Ft, Gd^Ft, Gd^Ft, Gd^Fts, Gll^Fts, Re, Re^Edb, Uhe^Dr, Hhd^Fts, Gd^Fts, Gd, Gd, Gd, Gll, Gd, Gd, Gd^Edp, Gll, Re^Edb, Uhe^Dr, Re^Edb, Gd^Fts, Gd, Gd, Gll, Gll
Gs^Ft, Gd^Ft, Gd^Ft, Gd^Fts, Gd^Fts, Hhd, Gll^Fts, Hhd^Fts, Hhd, Gll^Fts, Gd^Edp, Gd^Edp, Gll, Gll, Hhd^Fts, Hhd, Gll, Gll, Gd, Hhd^Fts, Gll^Edp, Gll, Gll, Gd, Gll, Gd^Fts
Gs^Ft, Gs^Ft, Gd^Ft, Gd^Ft, Gd^Ft, Gd^Fts, Gs^Fts, Gll, Gd, Gd, Gd, Gd^Edp, Gd, Re^Edb, Uhe^Dr, Hhd^Ft, Hhd^Ft, Gd^Fts, Rd, Gd, Gd, Gll, Gd, Gd^Fts, Gd^Ft, Gd^Fts
Wwt, Gs^Ft, Gs^Ft, Gd^Ft, Gd^Ft, Gd^Ft, Gd^Fts, Gll^Fts, Gd^Fts, Gd, Gd^Edb, Gd^Edb, Re, Gll^Feth, Re, Re^Edb, Gll, Gd^Fts, Gd^Edb, Gd^Fts, Gll, Gll, Gd^Fts, Gd^Fts, Gd^Ft, Gll^Fts
Wwt, Wwt, Wwt, Wwt, Wwt, Gs^Ft, Gs^Ft, Gs^Ft, Gs^Ft, Gd, Gd^Edb, Gd^Vhr, Gd^Edb, Re, Gd, Gll, Gll, Gd^Edb, Gd, Gll, Gll, Gd, Gd^Ft, Gd^Ft, Gd^Ft, Gd^Ft
Gs^Ft, Wwt, Wwt, Wwt, Wwt, Wwt, Wwt, Gs^Ft, Wwt, Gs^Ft, Gd, Gd^Edb, Re, Re, Gd^Fts, Gll, Gd^Ft, Gd^Fts, Gd^Ft, Gd^Fts, Gd, Gd^Ft, Gd^Ft, Gd^Ft, Gd^Ft, Gs^Ft
Gs^Ft, Gs^Ft, Gs^Ft, Gs^Ft, Gs^Ft, Wwt, Wwt, Wwt, Wwt, Wwt, Wwt, Gd, Re, Gll, Gd^Fts, Gd^Ft, Gs^Ft, Gd^Ft, Gd^Ft, Gd^Ft, Gs^Ft, Gs^Ft, Gs^Ft, Gs^Ft, Gs^Ft, Gs^Ft
Dd^Fts, Gs^Ft, Gs^Ft, Gs^Ft, Gs^Ft, Gs^Ft, Gs^Ft, Gs^Ft, Wwrt, Wwt, Wwt, Gll, Re, Gll, Wwt, Gs^Ft, Wwt, Gs^Ft, Wwt, Gd^Ft, Gs^Ft, Gs^Ft, Gs^Ft, Gs^Ft, Gs^Ft, Gs^Ft
Gs^Fts, Gs^Fts, Gs^Fts, Gs^Ft, Gs^Fts, Gs^Ft, Gs^Ft, Gs^Ft, Gs^Ft, Wwrt, Wwt, Ww, Ww^Bw|, Wwt, Wot, Wot, Wot, Wwt, Wwt, Gs^Ft, Wwrt, Wwrt, Wwrt, Wwt, Wwt, Ww
Gs^Fts, Gs^Fts, Gs^Fts, Gs^Fts, Gs^Fts, Gs^Fts, Gs^Fts, Gs^Ft, Gs^Ft, Wwrt, Wwrt, Ww, Re, Ww, Wwt, Wot, Wwt, Wot, Wwt, Wwt, Wwt, Wwt, Wwt, Wot, Wwt, Wwt
Gs^Fts, Gs^Fts, Gs^Fts, Gs^Fts, Gs^Edpp, Gs^Fts, Gs^Fts, Gs^Fts, Gs^Edpp, Gs^Fts, Gs, Gs, Re, Re, Cer, Cer, Cer^Esd, Wwt, Wwrt, Wwrt, Gs^Ft, Gs^Ft, Gs^Ft, Wwt, Gs^Ft, Gs^Ft
Gs^Fts, Gs^Fts, Gs^Edpp, Gs^Fts, Gs^Edpp, Gs^Fts, Gs^Fts, Gs^Fts, Gs, Gs, Gs, Gs, Gs^Edpp, Re, Cer^Esd, Kdr^Es, Cer^Esd, Gs^Fts, Gs^Fts, Gs^Ft, Gs^Ft, Gs^Ft, Gs^Ft, Gs^Ft, Gs^Ft, Gs^Ft
Gs, Gs^Fts, Gs^Edpp, Gs^Edpp, Gs, Gs^Fts, Gs^Edpp, Gs^Edpp, Gs^Edpp, Gs, Gs, Gs^Fts, Gs^Fts, Re, Re, Cer^Es, Re, Gs^Fts, Gs, Gs^Fts, Gs^Fts, Gs^Fts, Gs^Fts, Gs^Ft, Gs^Ft, Gs^Ft
Gs, Gs^Edpp, Gs, Gs^Efm, Gs^Efm, Gs^Efm, Gs, Gs^Edpp, Gs^Fts, Gs, Gs, Gs^Fts, Gs, Gs, Re, Re, Gs, Gs, Gs, Gs, Gs, Gs^Edpp, Gs^Edpp, Gs^Fts, Gs^Fts, Gs^Fts
Gs, Gs, Gs^Edpp, Gs, Gs, Gs^Efm, Gs, Gs, Gs^Fts, Gs^Fts, Gs, Gs, Gs, Gs, Re, Gs, Gs^Edpp, Gs, Gs^Efm, Gs^Efm, Gs^Efm, Gs^Edpp, Gs^Fts, Gs^Edpp, Gs^Fts, Gs^Fts
Gs, Gs^Fts, Gs^Fts, Gs^Fts, Gs^Edpp, Gs, Gs, Gs, Gs, Gs, Gs, Gs, Re, Re, Gs^Fts, Gs^Fts, Gs^Edpp, Gs^Edpp, Gs, Gs^Efm, Gs^Efm, Gs, Gs, Gs, Gs^Fts, Gs^Fts
Gs, Gs^Fts, Gs^Edpp, Gs^Fts, Gs^Fts, Gs, Gs, Gs, Gs, Gs, Re, Re, Gs, Gs^Fts, Gs^Fts, Gs^Fts, Gs^Fts, Gs^Edpp, Gs, Gs^Efm, Gs, Gs, Gs^Efm, Gs, Gs, Gs
Gs, Gs^Edpp, Gs, Gs, Gs, Gs, Gs, Gs, Gs, Re, Gs, Gs, Gd, Gs, Gs, Gs, Gs, Gs, Gs, Gs, Gs, Gs, Gs, Gs, Gs^Edpp, Gs
Gd, Gs, Gd, Gs, Gs, Gs, Gd, Gs^Vh, Re, 1 Re, Gs, Gd, Gd, Gd, Gs, Gs, Gs, Gs, Gd^Fts, Gs, Gd^Edpp, Gs^Edpp, Gs, Gs, Gs^Fts, Gs
Gd, Gd^Fts, Gd, Gd, Gd, Gd, Gd, Gd, Re, Gd^Edpp, Gd^Edpp, Gd, Gd, Gd, Gd, Gs, Gd, Gs, Gd, Gd, Gd^Edpp, Gs^Edpp, Gs^Fts, Gs^Fts, Gs^Fts, Gs^Fts
Gd, Gd, Gd, Gd, Gd, Gd, Gd, Gd, Re, Gd^Edpp, Gd, Gd, Gd, Gd, Gd, Gd, Gd, Gd, Gd, Gd, Gd, Gd^Fts, Gd^Fts, Gd^Fts, Gd^Fts, Gd
Gs, Gd, Gs, Gd, Gs, Gd, Gs, Gs, Gs, Gs, Gd, Gd, Gd, Gd, Gs, Gd, Gs, Gd, Gd, Gd, Gd, Gd, Gd, Gd, Gd, Gd
