Xu, Xu, Xu, Xu, Xu, Xu, Xu, Xu, Xu, Xu, Xu, Xu, Xu, Xu, Xu, Xu, Xu, Uh, Uh, Xue, Xue, Xue, Xue, Xu, Xu, Xu, Xu, Xu, Xu, Xu, Xu, Xu, Xu, Xu, Xu, Xu
Xu, Xu, Xu, Xu, Xu, Xu, Xu, Xu, Xu, Xu, Xu, Xu, Xu, Xu, Xu, Xu, Xue, Uh, Tb^Tf, Xue, Rb^Emf, Rb^Emf, Rb^Emf, Xue, Xue, Xu, Xu, Xu, Xu, Xu, Xu, Xu, Xu, Xu, Xu, Xu
Xu, Xu, Xu, Xu, Xu, Xu, Xu, Xu, Xu, Xu, Xu, Xu, Xu, Xu, Xu, Xu, Xue, Tb^Tf, Rb^Emf, Rb^Emf, Rb^Emf, Rb^Emf, Rb^Emf, Rb^Emf, Xuc, Xue, Xuc, Xu, Xu, Xu, Xu, Xu, Xu, Xu, Xu, Xu
Xu, Xu, Xu, Xu, Xu, Xu, Xu, Xu, Xu, Xu, Xu, Xu, Xu, Xu, Xu, Xu, Xuc, Uh, Uh^Em, Rb^Emf, Uu^Em, Rb^Emf, Uh^Tf, Xuc, Uu^Em, Xom, Xuc, Xuc, Xu, Xu, Xu, Xu, Xu, Xu, Xu, Xu
Xu, Xu, Xu, Xu, Xu, Xu, Xu, Xu, Xu, Xu, Xu, Xu, Xu, Xu, Xu, Xue, Xom^Efs, Xom, Uu, Uu^Em, Ior^Em, Uu^Em, Rb, Rb, Rb^Em, Uu^Em, Xuc^Efs, Xuc, Xu, Xu, Xu, Xu, Xu, Xu, Xu, Xu
Xu, Xu, Xu, Xu, Xu, Xu, Xu, Xu, Xu, Xu, Xu, Xu, Xu, Xu, Xu, Xom, Uh, Uu, 3 Uu^Vc, Uu^Em, Ior, Ior, Ior, Ior, Ior, Ior, Rb, Xuc, Xuc, Xu, Xu, Xu, Xu, Xu, Xu, Xu
Xu, Xu, Xu, Xu, Xu, Xu, Xu, Xu, Xu, Xu, Xu, Xu, Xu, Xu, Xuc, Xom, Uu, Uu, Ior, Rb, Ior, Urc, Urc, Ior, Urc, Ior, Rb, Rb, Rb, Xuc, Xu, Xu, Xu, Xu, Xu, Xu
Xu, Xu, Xu, Xu, Xu, Xu, Xu, Xu, Xu, Xu, Xu, Xu, Xu, Xu, Xuc, Uu, Uu, Rb, Ior, Urc, Urc, Urc, Urc, Urc, Urc, Ior, Ior, Ior, Xom^Efs, Xuc, Xu, Xu, Xu, Xu, Xu, Xu
Xu, Xu, Xu, Xu, Xu, Xu, Xu, Xu, Xu, Xu, Xu, Xu, Xu, Xu, Xuc, Uh, Uu, Uu, Ior, Ior, Urc, Urc, Urc, Urc, Ior, Urc, Ior, Rb, Xuc, Xu, Xu, Xu, Xu, Xu, Xu, Xu
Xu, Xu, Xu, Xu, Xu, Xu, Xu, Xu, Xu, Xu, Xu, Xu, Xu, Xu, Xuc, Uh, Uh, Ior, Rb, Urc, Ior, Ior, Urc, Ior, Ior, Ior, Rb, Rb, Rb, Xuc, Xu, Xu, Xu, Xu, Xu, Xu
Xu, Xu, Xu, Xu, Xu, Xu, Xu, Xu, Xu, Xu, Xu, Xu, Xu, Xu, Xu, Uh, Uh, Uu, Uu, Rb, Ior, Ior, Ior, Ior, Rb, Ior, Uu, Rb, Rb, Xuc, Xu, Xu, Xu, Xu, Xu, Xu
Xu, Xu, Xu, Xu, Xu, Xu, Xu, Xu, Uh, Xu, Uh, Uh, Uh, Xu, Xu, Xuc, Uh, Uu, Uh, Uu, Uu, Rb, Uu, Rb, Uh, Uu, Uu, Uu, Xuc, Xuc, Xu, Xu, Xu, Xu, Xu, Xu
Xu, Xu, Xu, Xu, Xu, Xu, Xu, Uh, Xu, Uh, Xu, Xu, Xu, Uh, Uh, Uh, Xu, Uh, Xuc, Xuc, Xu, Xuc^Efs, Xuc, Uh, Uh, Uh, Rr^Pw/, Xuc, Tb^Dr, Xu, Xu, Xu, Xu, Xu, Xu, Xu
Xu, Xu, Xu, Xu, Xu, Xu, Xu, Xu, Xu, Xu, Xu, Xu, Xu, Xu, Xu, Xu, Xu, Xu, Xu, Xuc, Xu, Xuc, Xu, Xuc, Xuc, Xuc, Uhe^Edb, Rb, Uu, Xu, Xu, Xu, Xu, Xu, Xu, Xu
Xu, Xu, Xu, Xu, Xu, Xu, Xu, Xu, Xu, Xu, Xu, Xu, Xu, Xu, Xu, Xu, Xu, Xu, Xu, Xu, Xu, Xu, Xu, Xu, Xuc, Uu, Rb, Rb, Uhe^Dr, Xu, Xu, Xu, Xu, Xu, Xu, Xu
Xu, Xu, Xu, Xu, Xu, Xu, Xu, Xu, Xu, Xu, Xu, Xu, Xu, Xu, Xu, Xu, Xu, Xu, Xu, Uh, Uh, Xu, Xu, Xu, Xuc, Uu, Uu, Uu^Em, Uhe, Uh^Qov, Uh, Xu, Uh, Xu, Xu, Xu
Xu, Xu, Xu, Xu, Xu, Xu, Xu, Xu, Xu, Xu, Xu, Xu, Xu, Xu, Xu, Uh, Uh, Xu, Xu, Xu, Uh, Xu, Uhe, Uh^Dr, Uu^Edb, Rb^Edb, Rb, Uh, Xuc, Xuc, Xu, Uh, Xu, Uh, Xu, Xu
Xu, Xu, Xu, Xu, Xu, Xu, Xu, Xu, Xu, Xu, Xu, Xu, Xu, Xu, Xu, Xu, Uh, Xu, Xu, Xu, Uh^Qov, Xu, Xu, Uh^Edb, Rb, Uu^Edb, Uu^Edb, Rb, Rb^Pw/, Xu, Xu, Xu, Xu, Xu, Xu, Xu
Xu, Xu, Xu, Xu, Xu, Xu, Xu, Xu, Xu, Xu, Xu, Xu, Xu, Xu, Xu, Xu, Uh, Xu, Xu, Xu, Xu, Tb, Uu^Em, Uu^Em, Rb, Uu, Uhe, Xuc, Xu, Uue, Uue, Xu, Xu, Xu, Xu, Xu
Xu, Xu, Xu, Xu, Xu, Xu, Xu, Xu, Xu, Xu, Xu, Xu, Xu, Xu, Xu, Xu, Xu, Tb^Qov, Uh, Uhe, Uue^Vu, Uhe^Edb, Uu^Em, Rb^Em, Uu, Tb^Dr, Xu, Xue, Xu, Xu, Xu, Uu, Xu, Xu, Xu, Xu
Xu, Xu, Xu, Xu, Xu, Xu, Uue^Dr, Uue, Uue, Xu, Xu, Xu, Xu, Xu, Xuc, Xu, Xu, Xu, Uh, Uh, Uhe^Edb, Uhe^Edb, Uu, Uu, Uu, Uh, Xu, Xu, Xu, Xu, Xu, Uue, Uue, Xu, Xu, Xu
Xu, Xu, Xu, Xu, Xu, Xu, Xu, Xu, Xu, Uue, Xu, Xu, Xuc, Xuc, Uhe, Xuc, Uu^Dr, Uu, Rb, Uu, Rb, Rb, Uh, Uu, Xu, Tb^Qov, Uh, Xu, Xu, Xu, Xue, Xue, Uue, Xu, Xu, Xu
Xu, Xu, Xu, Xu, Xu, Xu, Xu, Xu, Xu, Uue, Uu^Em, Uh, Tb^Dr, Uhe, Rb^Edb, Uu, Uh, Uu, Xu, Xu, Xu, Tb^Dr, Xu, Xu, Xu, Xu, Uh, Xu, Xu, Xue, Xue, Xue, Xue, Uu, Uue, Uu
Xu, Xu, Xu, Xu, Xu, Xu, Xu, Xu, Xu, Uu^Em, Uu^Em, Uu, Rb^Edb, Uh^Edb, Rb^Edb, Uue, Uhe, Xu, Xu, Xu, Uue, Uue, Xu, Xu, Xue, Xu, Uh, Xu, Xu, Xue, Xue, Xue, Xue, Xu, Xu, Xu
Xu, Xu, Xu, Xu, Xu, Xu, Tb^Dr, Uhe, Uu, Uu^Em, Rb, Uu, Uu, Rb^Edb, Uu^Em, Uhe, Xu, Xu, Xu, Xu, Uhe, Tb, Tb, Xu, Xue, Xu, Xue, Uh, Xu, Xu, Xue, Xue, Xue, Xue, Xue, Xu
Xu, Xu, Xu, Xu, Xu, Xu, Uhe, Uhe, Uu^Edb, Rb, Uu^Em, Uu^Em, Xu, Xu, Xu, Rb, Uu, Xu, Xu, Xu, Xu, Tb, Tb, Xu, Xue, Xu, Xu, Uh, Uh, Xu, Xu, Xue, Xue, Xue, Xue, Xue
Xu, Xu, Xu, Xu, Xu, Uu, Rb, Rb, Uu, Uh^Edb, Uh, Uh^Em, Xu, Xu, Xu, Xu, Uhe, Xu, Xu, Xu, Xu, Xu, Tb, Xu, Xu, Xue, Xue, Xue, Xu, Xu, Xue, Xue, Xue, Xue, Xue, Xue
Xu, Xu, Xu, Xu, Uu, Uu^Edb, Rb, Uu, Uhe, Uh, Xu, Xu, Xu, Xu, Xu, Xu, Tb, Tb, Tb, Xu, Xu, Xu, Tb, Xu, Xu, Xu, Xu, Xu, Xu, Xu, Xu, Xu, Xu, Xue, Xue, Xue
Xu, Xu, Xu, Xu, Uue^Dr, Uu, Rb^Es, Uu, Uhe, Tb^Dr, Xu, Xu, Xu, Xu, Xu, Xu, Xu, Tb, Xu, Tb, Tb, Tb, Xu, Xu, Xu, Xu, Xu, Xu, Xu, Xu, Xu, Xu, Xu, Xu, Xu, Xue
Xu, Xu, Xu, Xu, Uu, Uu, Rb, Uu, Uh, Uhe, Xu, Xu, Xu, Xu, Xu, Xu, Xu, Xu, Xu, Xu, Xu, Xu, Xu, Xu, Xu, Xu, Xu, Xu, Xu, Xu, Xu, Xu, Xu, Xu, Xu, Xu
Xu, Xu, Xu, Xu, Uh, Rb, Uu, Uh, Uh, Xu, Xu, Xu, Xu, Xu, Xu, Xu, Xu, Xu, Xu, Xu, Xu, Xu, Xu, Xu, Xu, Xu, Xu, Xu, Xu, Xu, Xu, Xu, Xu, Xu, Xu, Xu
Xu, Xu, Xu, Uh, Uu, Rb, 1 Rb, Uu, Xu, Xu, Xu, Xu, Xu, Xu, Xu, Xu, Xu, Xu, Xu, Xu, Xu, Xu, Xu, Xu, Xu, Xu, Xu, Xu, Xu, Xu, Xu, Xu, Xu, Xu, Xu, Xu
Xu, Xu, Xu, Uh, Uu, Uu, Rb, Uu, Uh, Xu, Xu, Xu, Xu, Xu, Xu, Xu, Xu, Xu, Xu, Xu, Xu, Xu, Xu, Xu, Xu, Xu, Xu, Xu, Xu, Xu, Xu, Xu, Xu, Xu, Xu, Xu
Xu, Xu, Xu, Xu, Uu, Uu, Uue, Uu, Xu, Xu, Xu, Xu, Xu, Xu, Xu, Xu, Xu, Xu, Xu, Xu, Xu, Xu, Xu, Xu, Xu, Xu, Xu, Xu, Xu, Xu, Xu, Xu, Xu, Xu, Xu, Xu
Xu, Xu, Xu, Xu, Uu^Ii, Uue^Ii, Uue^Ii, Uue^Ii, Xu, Xu, Xu, Xu, Xu, Xu, Xu, Xu, Xu, Xu, Xu, Xu, Xu, Xu, Xu, Xu, Xu, Xu, Xu, Xu, Xu, Xu, Xu, Xu, Xu, Xu, Xu, Xu
